20
18
5
4
####################
#a```^````````````X#
#``````````````````#
#``````````````````#
#``````````````````#
#``````````````````#
#``````````````````#
#``````B```````````#
#``````````````````#
#``````````````````#
#``````````````````#
#``````````^```````#
#`````````X`A``````#
#```#``````````````#
#``````````````````#
#``````````````````#
#`````````#```````b#
####################
